1 1 1 1 1 1 1 1 1 1 1 1 1 1 1 1 1 1 1 1 1 1 1 1 1 1 1 1 1 1 1 1 
1 0 0 0 0 0 0 16 16 0 1 14 0 0 0 0 0 0 0 0 14 1 0 16 16 0 0 0 0 0 0 1 
1 0 0 0 0 0 0 0 0 0 1 0 0 0 0 17 0 0 0 0 0 1 0 0 0 0 0 0 0 0 0 1 
1 0 0 17 0 0 0 0 0 0 1 0 0 0 0 0 0 0 0 0 0 1 0 0 0 0 0 0 17 0 0 1 
1 0 0 0 0 0 0 0 0 14 1 0 0 0 0 0 0 0 0 0 0 1 14 0 0 0 0 0 0 0 0 1 
1 0 0 0 0 0 0 0 0 14 1 1 1 15 0 0 0 0 15 1 1 1 14 0 0 0 0 0 0 0 0 1 
1 0 0 0 0 0 0 0 0 0 0 0 1 15 0 0 0 0 15 1 0 0 0 0 0 0 0 0 0 0 0 1 
1 16 0 0 0 0 0 0 0 0 0 0 1 1 0 0 0 0 1 1 0 0 0 0 0 0 0 0 0 0 16 1 
1 16 0 0 0 0 0 0 0 0 0 0 0 0 0 0 0 0 0 0 0 0 0 0 0 0 0 0 0 0 16 1 
1 0 0 0 14 14 0 0 0 0 0 0 0 0 0 0 0 0 0 0 0 0 0 0 0 0 14 14 0 0 0 1 
1 1 1 1 1 1 0 0 0 0 0 15 15 0 0 0 0 0 0 15 15 0 0 0 0 0 1 1 1 1 1 1 
1 14 0 0 0 1 0 0 0 0 0 15 1 1 0 0 0 0 1 1 15 0 0 0 0 0 1 0 0 0 14 1 
1 0 0 0 0 1 1 1 0 0 0 1 1 13 0 0 0 0 13 1 1 0 0 0 1 1 1 0 0 0 0 1 
1 0 0 0 0 15 15 1 0 0 0 1 12 0 0 0 0 0 0 12 1 0 0 0 1 15 15 0 0 0 0 1 
1 0 0 0 0 0 0 0 0 0 0 0 0 0 0 0 0 0 0 0 0 0 0 0 0 0 0 0 0 0 0 1 
1 0 17 0 0 0 0 0 0 0 0 0 0 0 0 0 17 0 0 0 0 0 0 0 0 0 0 0 0 0 0 1 
1 0 0 0 0 0 0 0 0 0 0 0 0 0 0 0 0 0 0 0 0 0 0 0 0 0 0 0 0 17 0 1 
1 0 0 0 0 0 0 0 0 0 0 0 0 0 0 0 0 0 0 0 0 0 0 0 0 0 0 0 0 0 0 1 
1 0 0 0 0 15 15 1 0 0 0 1 12 0 0 0 0 0 0 12 1 0 0 0 1 15 15 0 0 0 0 1 
1 0 0 0 0 1 1 1 0 0 0 1 1 13 0 0 0 0 13 1 1 0 0 0 1 1 1 0 0 0 0 1 
1 14 0 0 0 1 0 0 0 0 0 15 1 1 0 0 0 0 1 1 15 0 0 0 0 0 1 0 0 0 14 1 
1 1 1 1 1 1 0 0 0 0 0 15 15 0 0 0 0 0 0 15 15 0 0 0 0 0 1 1 1 1 1 1 
1 0 0 0 14 14 0 0 0 0 0 0 0 0 0 0 0 0 0 0 0 0 0 0 0 0 14 14 0 0 0 1 
1 16 0 0 0 0 0 0 0 0 0 0 0 0 0 0 0 0 0 0 0 0 0 0 0 0 0 0 0 0 16 1 
1 16 0 0 0 0 0 0 0 0 0 0 1 1 0 0 0 0 1 1 0 0 0 0 0 0 0 0 0 0 16 1 
1 0 0 0 0 0 0 0 0 0 0 0 1 15 0 0 0 0 15 1 0 0 0 0 0 0 0 0 0 0 0 1 
1 0 0 0 0 0 0 0 0 14 1 1 1 15 0 0 0 0 15 1 1 1 14 0 0 0 0 0 0 0 0 1 
1 0 0 0 0 0 0 0 0 14 1 0 0 0 0 0 0 0 0 0 0 1 14 0 0 0 0 0 0 0 0 1 
1 0 0 17 0 0 0 0 0 0 1 0 0 0 0 0 0 0 0 0 0 1 0 0 0 0 0 0 17 0 0 1 
1 0 0 0 0 0 0 0 0 0 1 0 0 0 0 0 17 0 0 0 0 1 0 0 0 0 0 0 0 0 0 1 
1 0 0 0 0 0 0 0 0 0 1 14 0 0 0 0 0 0 0 0 14 1 0 16 16 0 0 0 0 0 0 1 
1 1 1 1 1 1 1 1 1 1 1 1 1 1 1 1 1 1 1 1 1 1 1 1 1 1 1 1 1 1 1 1 
